---------
/       l
/       m
*       b
-       t
g       -
-g-----p-

Burger

2 1
4 1
4 4
2 4
3 3